############
#          #
#    .*.   #
#  \\\\\\  #
#      ..  #
#  \\\\\\\.#
#  \      .#
#  \     ..#
#        * #
#  ### ### #
#   R#\#\\.#
######L#####

Waterproof 10 
Flooding 10
Water 2
